11111111111111111111111111111111111111111111111111111111111111111111111111111111111111111111111111111111111111111111111111111111111111111111111111111111111111111111111111111111111111111111111111111111111
10000000000000000000000000000000000000000000000000000000000000000000000000000000000000000000000000000000000000000000000000000000000000000000000000000000000000000000000000000000000000000000000000000000001
10000000000000000000000000000000000000000000000000000000000000000000000000011110000000000000000000000000000000000000000000000000000000000000000000000000000000000000000000000000000000000000000000000000001
10000000000000000000000000000000000000000000111111111111111101111111111111111111111001111000000000000000000000000000000000000000000000000000000000000000000000000000000000000000000000000000000000000000001
10000000000000000000000000000000000000010111110111111110000111111111111111111111111111000000000000000111111111000000000000000000000000000000000000111100000000000000000000000000000000000000000000000000001
10000000000000000000000000000001110010010110101111110000111111111111111111111111111110000000000000000001110110000000000000000000000000000000000000000000100000000000000000000000000000000000000000000000001
10000000000000000000000000000011111101111011111111100000000000111111111111111111111110000000000000000000000000000000000000000001111100000000000001111111111111000000000000011111000000000000000000000000001
10000000000000000000000000111110000110111111001011110000000000001111111111111111111100000000000000000000000000000000000000000110000000100000111111111111110111111001110000000110000000000000000000000000001
10000001110000000000000000100111111110000110011111111111000000000111111111111111111000000000000000000000000001110000000000001110000011111111111111111111111111111111111011111111111101100000000000111000001
10111111111111111111111111111111111110001111110111001111110000000111111111111111100000000000000000000001111111111111100110011011111111110111111111111111111111111111111111111111111111111111111111110000001
10111111111111111111111111101111111111111111111100000011111100000111111111100000001111100000000000000011111111111110011111111111111111111111111111111111111111111111111111111111111111111111111111111111101
10011111111111111111111111111111111111111111100100000001111000000001111100000000000000000000000000011111110111111111111111111111111111111111111111111111111111111111111111111111111111111111111111100000101
10111111111111111111111111111111111111111100000000001111000100000000001000000000000000000000001000111111110010011111111111111111111111111111111111111111111111111111111111111111111110000111110000000000001
10000001010000000001111111111111111111111111100000001111111110000000000000000000000000000000110000001011110111111111111111111111111111111111111111111111111111111111111111111000000000111100000000000000001
1000000000000000000001111111111111111111111111111001111111111110000000000000000000000000001100100P001111111111111111111111111111111111111111111111111111111111111111111111111000000001110000000000000000001
10000000000000000000000101111111111111111111111111111111111111010000000000000000000000000000111011111111111111111111111111111111111111111111111111111111111111111111111111111010000000000000000000000000001
10000000000000000000000000111111111111111111010011111111111000001100000000000000000000000000001111111111111111111111111111111111111111111111111111111111111111111111111111110000000000000000000000000000001
10000000000000000000000000111111111111111111110111101111001000000000000000000000000000000011111111110110111111100000011111011111111111111111111111111111111111111111111111000111000000000000000000000000001
10000000000000000000000000111111111111111111111111111100000000000000000000000000000000000011111000001000101101111111111111101111111111111111111111111111111111111111110000001100000000000000000000000000001
10000000000000000000000000011111111111111111111111111000000000000000000000000000000000000000000111111100000000010101111111111111111111111111111111111111111111111100011000111000000000000000000000000000001
10000000000000000000000000000011111111111111111111000000000000000000000000000000000000000011111111111111001110000011111111111111111111111111111111111111111111111100000100000000000000000000000000000000001
10000000000000000000000000000001111111111000000001000000000000000000000000000000000000001111111111111111111111111111111111011111111111111111111111111111111111111100000000000000000000000000000000000000001
10000000000000000000000000000000010111111000000000000000000000000000000000000000000000111111111111111111111111111110111111111111000001111111111111111111111111110100000000000000000000000000000000000000001
10000000100000000000000000000000000011111100110000000011100000000000000000000000000000111111111111111111111111111111001111111110000000011111111000011111110100000000000000000000000000000000000000000000001
10000000000000000000000000000000000000000001111110000000000000000000000000000000000000111111111111111111111111111111110111110000000000001111000000000111111000000100000000000000000000000000000000000000001
10000000000000000000000000000000000000000000000100000111100000000000000000000000000000011111111111111111111111111111111011110000000000000111000000000100111000000010000000000000000000000000000000000000001
10000000000000000000000000000000000000000000000000001111111111100000000000000000000000000111111111111111111111111111111111000000000000000000100000000010000000010001100000000000000000000000000000000000001
10000000000000000000000000000000000000000000000000011111111111111110000000000000000000000000000000000111111111111111111100000000000000000000000000000111100011110000000000000000000000000000000000000000001
10000000000000000000000000000000000000000000000000111111111111111111111100000000000000000000000000000111111111111111100000000000000000000000000000000011110011101100000011111000000000000000000000000000001
10000000000000000000000000000000000000000000000000111111111111111111111111110000000000000000000000000011111111111111100000000000000000000000000000000000011111000000000000001111100001000000000000000000001
10000000000000000000000000000000000000000000000000001111111111111111111111100000000000000000000000000001111111111111100000000000000000000000000000000000000000000000000000000100000000000000000000000000001
10000000000000000000000000000000000000000000000000000111111111111111111111000000000000000000000000000011111111111111100111100000000000000000000000000000000000000000111111100111000000000000000000000000001
10000000000000000000000000000000000000000000000000000000111111111111111110000000000000000000000000000011111111111100000111C00000000000000000000000000000000000000111111111111111100000000000000000000000001
10000000000000000000000000000000000000000000000000000000111111111111100000000000000000000000000000000001111111111110000110000000000000000000000000000000000001111111111111111111111000000000000000000000001
10000000000000000000000000000000000000000000000000000001111111111111000000000000000000000000000000000000111111111000000000000000000000000000000000000000000000111111111111111111111100000000000000000000001
100000000000000000000000000000000000000000000000000000011111111111E0000000000000000000000000000000000000011111100000000000000000000000000000000000000000000000011111110011111111111100000000000000000000001
10000000000000000000000000000000000000000000000000000011111111110000000000000000000000000000000000000000000000000000000000000000000000000000000000000000000000000000000000101111110000000000000100000000001
10000000000000000000000000000000000000000000000000000011111100000000000000000000000000000000000000000000000000000000000000000000000000000000000000000000000000000000000000000000000000000000000010000000001
10000000000000000000000000000000000000000000000000000011111000000000000000000000000000000000000000000000000000000000000000000000000000000000000000000000000000000000000000000000000000000000011000000000001
10000000000000000000000000000000000000000000000000000111111000000000000000000000000000000000000000000000000000000000000000000000000000000000000000000000000000000000000000000000000000000000000000000000001
10000000000000000000000000000000000000000000000000000111100000000000000000000000000000000000000000000000000000000000000000000000000000000000000000000000000000000000000000000000000000000000000000000000001
10000000000000000000000000000000000000000000000000000011110000000000000000100000000000000000000000000000000000000000000000000000000000000000000000000000000000000000000000000000000000000000000000000000001
10000000000000000000000000000000000000000000000000000000000000000000000000000000000000000000000000000000000000000000000000000000000000000000000000000000000000000000000000000000000000000000000000000000001
11111111111111111111111111111111111111111111111111111111111111111111111111111111111111111111111111111111111111111111111111111111111111111111111111111111111111111111111111111111111111111111111111111111111