111111111111111111111
100000000000000000001
100000000000000000001
1000000000000E0000001
100000000C00000000001
1000P0000000000000001
111111111111111111111