111111111111111111111
100000000000000000001
100000000000000000001
1000000000000E0000001
100000000C00000000011
1000P00000000000000C1
111111111111111111111