111111111111111111111
100000000000000000001
111101000000000000001
1000010000000E0000001
101111000C00000000011
1000P10000000000000C1
111111111111111111111